0,0,0,0,0,0,0,0,0,0
0,0,0,0,0,0,0,0,0,0
0,0,200,0,1,0,3,1,1,0
0,0,0,0,0,0,0,0,0,0
0,0,1,0,0,20,0,0,0,0
0,0,0,0,0,0,1,0,0,0
0,0,0,0,0,0,1,0,0,0
0,0,3,1,1,0,4,200,1,0
0,10,0,0,0,0,0,0,0,0
0,0,1,0,0,0,0,0,0,0