0,0,0,0,0,0,0,0,0,0
0,0,200,0,0,0,0,0,0,0
0,0,3,0,0,0,3,1,0,0
0,0,0,0,0,0,0,0,0,0
0,0,1,0,0,0,0,0,0,0
0,0,0,0,0,0,0,0,0,0
0,0,0,0,0,0,1,100,0,0
0,0,4,0,0,0,3,0,0,0
0,0,0,0,0,0,0,0,0,0
0,0,1,0,0,0,0,0,0,0