0,0,0,0,0,0,0,0,0,0
0,0,0,0,0,0,0,0,0,0
1,1,103,0,1,0,103,1,1,0
0,0,0,0,0,0,0,0,0,0
0,0,1,0,0,0,1,0,0,0
0,0,0,0,0,0,1,0,0,0
0,0,0,0,0,0,1,0,0,0
0,0,3,1,1,0,3,0,0,0
0,10,0,0,0,0,0,10,0,0
0,0,1,0,0,0,0,0,0,0