0,0,0,0,0,0,1,0,0,0,0,0,20,0,0,0,0,0,0,300
0,0,1,0,0,0,1,0,0,0,10,0,0,0,0,0,0,0,0,300
0,0,1,0,0,20,3,0,0,0,1,1,1,0,3,0,1,300,0,400
0,0,3,0,1,0,0,0,0,0,3,0,0,0,0,0,0,0,0,300
0,0,0,0,0,0,1,0,0,0,0,0,0,0,0,0,0,0,0,300
0,0,1,0,0,0,0,0,0,0,1,0,0,0,0,0,0,300,0,0
0,0,0,0,1,1,3,0,0,0,1,0,0,0,3,0,1,1,0,300
0,0,3,0,0,0,0,20,1,0,3,0,0,0,0,0,0,0,0,300
0,10,1,0,0,0,0,0,0,0,0,0,0,0,0,0,0,300,0,400
0,0,1,300,0,0,0,0,0,0,0,0,0,10,0,0,0,0,0,300